	/*= {
	"YVVVVVVVVVVVVVVVVVVVVVVVVVVVVVVVVVVVVVVVVVVVVVVVVVVVVVVVVVVVVVVVVVVVVVVVVVVVVVVVVVVVVVVVVVVVVVVVVVVVVVVVVVVVVVVVVVVVVVVVVVVVVVVVVVVVVVVVVVVVVVVVVVVVVVVVVVVVVVV0",
	"2     F                                                                                                                                                        0",
	"2     F                                                                                                                                                        0",
	"2     F                                                                                                                                                        0",
	"2     F                                                                                                                                                        0",
	"2     F                                                            B      B       B                                                                            0",
	"2     F                                                       ------------------------------------                                                             0",
	"2     F                                                                                                                                                        0",
	"2     F                                                    ---                                                                                                 0",
	"2     F                                                       ---                                 ---                                                          0",
	"2     F                                                          ---                                                                   0                       0",
	"2     F                                                             --         -                                                      00                       0",
	"2     F                                                             -----      -                     ---                             000                       0",
	"2     F                                                             --      ----                                                    0000                       0",
	"2    ZZZ                                                            ------     -                                                   00000                       0",
	"2    ZZZ                                        B        B          --                                                            000000                       0",
	"2    ZZZ                               ------ G________________T    XXXXXXXXXXXXXXXX   G__T           ----GT                     0000000                       0",
	"2                                  --         10000000000000000L__T    XXXXXXXXXXX    GJ002               1LT                   00000000                       0",
	"2                  ---        --              10000000000000000000L_T               G_J0002               10LT                 000000000                       0",
	"2             GT         GT                   1000000000000000000000L_______________J000002              B100LT               0000000000                       0",
	"2             12sssssssss12sssssssssssssssssss100000000000000000000000000000000000000000002sssssssssss- BB1000LT     ss      00000000000sssssssssssssssssssssss0",
	"L_____________JL_________JL___________________J0000000000000000000000000000000000000000000L__________T-BBB10000L_____________00000000000000000000000000000000000",
	"00000000000000000000000000000000000000000000000000000000000000000000000000000000000000000000000000000J____J00000000000000000000000000000000000000000000000000000",
	"0000000000000000000000000000000000000000000000000000000000000000000000000000000000000000000000000000000000000000000000000000000000000000000000000000000000000000",
	"0000000000000000000000000000000000000000000000000000000000000000000000000000000000000000000000000000000000000000000000000000000000000000000000000000000000000000",
	};
	*/
	/*
	sf::String TileMap[25] = {
	"0000000000000000000000000000000000000000000000000000000000000000000000000000000000000000000000000000000000000000000000000000000000000000000000000000000000000000",
	"0                                                                                                                                                              0",
	"0                                                                                                                                                              0",
	"0                                                                                                                                                              0",
	"0                                                                                                                                                              0",
	"0                                                                                                                                                              0",
	"0                                                                                                                                                              0",
	"0                                                                                                                                                              0",
	"0                                                                                                                                                              0",
	"0                                                                                                                                                              0",
	"0                                                                                                                                      0                       0",
	"0                                                                                                                                     00                       0",
	"0                                                                                                                                    000                       0",
	"0                                                                                                                                   0000                       0",
	"0                                                                                                                                  00000                       0",
	"0                                               0        0                                                                        000000                       0",
	"0                                      000000 00000000000000                                                                     0000000                       0",
	"0                                  00         000000000000000                                                                   00000000                       0",
	"0                             00              0000000000000000                                                                 000000000                       0",
	"0             00   000   00                   00000000000000000                                                               0000000000                       0",
	"0             00sssssssss00sssssssssssssssssss000000000000000000            ssss                    00        00        00   00000000000sssssssssssssssssssssss0",
	"000000000000000000000000000000000000000000000000000000000000000000000000    000000000000000   000000000000000000000000000000000000000000000000000000000000000000",
	"00000000000000000000000000000000000000000000000000000000000000000000000000    00000000000    0000000000000000000000000000000000000000000000000000000000000000000",
	"00000000000000000000000000000000000000000000000000000000000000000000000000000              000000000000000000000000000000000000000000000000000000000000000000000",
	"0000000000000000000000000000000000000000000000000000000000000000000000000000000000000000000000000000000000000000000000000000000000000000000000000000000000000000",
	};
	*/